1111111111111111111111111111111111111111111111111111111111111111111111111111111111
1E0000000000000C00000C000000000000000000000000000000000111110001010101010100011101
1010010100100000101001000000010100000010110101000010100000000111111110101010000001
1010010010101010001001000000010100P00011111111110111100000000000000100001010010001
100000000C00C0000000000000000000C0000000000000011111100010110101010101000000101011
100001001010010000010010101000C010010101001111111111111010101010101010101011010101
11100000001010101010100000CCCCCCCC111001001010000101001000100100100111001010100001
1010100100010010101001011001CCCCCCCCCCCCCCCC11001001000001001001000010001000100011
1111111111111111111111111111111111111111111111111111111111111111111111111111111111