11111111111111111111111111111111111111111111111111111111111
10000000000000000000000000000000000000000000000000000000C01
10000000000000000000000000000000000000000000000000000000001
100000000000000P0000000000000000000000000000000000000000E01
10000000000000000000000000000000000000000000000000000000001
10000000000000000000000000000000000000000000000000000000001
11111111111111111111111111111111111111111111111111111111111