1111111
1011111
10P0001
10C0001
10E0001
1000001
1111111
